water_layer
24
moore

000000000000000000000000
000213333210000000000000
003000000003333330000000
000333333330000003000000
000000000000000033330000
000000000000000030033333
000000000000000033330000
000213333330000003000000
003000000003333210000000
000333213330000000000000
000000000000000000000000
000000000000000000000000
000000000000000000000000
000000000000000000000000
000000000000000000000000
000000000000000000000000
000000000000000000000000
000000000000000000000000
000000000000000000000000
000000000000000000000000
000000000000000000000000
000000000000000000000000
000000000000000000000000
000000000000000000000000


head blue
tail red
conductor yellow
