water_layer
24 11
moore

000000000000000000000000
002133332100000000000000
030000000033333300000000
003333333300000030000000
000000000000000333300000
000000000000000300333330
000000000000000333300000
002133333300000030000000
030000000033332100000000
003331233300000000000000
000000000000000000000000

head blue
tail red
conductor yellow
